1111111111111111111111111111
1P010000000010000000001000E1
1001000100001000001000100001
1001000100001000001000100001
10010C010C00100C0010C0100C01
1001000100001000001000100001
1000000100000000001000000001
1111111111111111111111111111