11111111111111111111111111111111111111
1PE10000000010000000001000000000000001
10010001000010000010001000000000000001
10010001000010000010001000000000000001
10000000000000000000000000000000000001
10000000000000000000000000000000000001
10000000000000000000000000000000000001
10000000000000000000000000000000000001
10000000000000000000000000000000000001
10000000000000000000000000000000000001
10000000000000000000000000000000000001
10000000000000000000000000000000000001
10000000000000000000000000000000000001
10000000000000000000000000000000000001
10000000000000000000000000000000000001
10010C010C00100C0010C0100C000000000001
10010001000010000010001000000000000001
10000001000000000010000000000000000001
10000000000000000000000000000000000001
11111111111111111111111111111111111111
