111111111111111111
1P000000000000C0E1
111111111111111111